,이름,학번,국어,수학,영어,합계,평균,석차
0,홍길동,1,90,85,60,235,78.33333333333333,6.0
1,강감찬,2,85,75,65,225,75.0,8.0
2,나원참,3,78,83,95,256,85.33333333333333,4.0
3,이순신,4,90,95,90,275,91.66666666666667,2.0
4,나홀로,5,88,72,70,230,76.66666666666667,7.0
5,태평양,6,88,92,99,279,93.0,1.0
6,대서양,7,69,78,77,224,74.66666666666667,9.0
7,인도양,8,79,96,90,265,88.33333333333333,3.0
8,백두산,9,88,56,45,189,63.0,10.0
9,한라산,10,88,96,66,250,83.33333333333333,5.0
